
NO ./xpms/path_to_the_north_texture.xpm
SO ./xpms/path_to_the_south_texture.xpm
WE ./xpms/path_to_the_west_texture.xpm
EA ./xpms/path_to_the_east_texture.xpm

C 25, 158, 243
F 250,250,250


11111111111111111111111111111111111111
11111111101100000000000011111111111111
        101100000111000001111111111111
        100100000000000000000000111111
11111111101100000111000000000000111111
10000000001100000111011111111111111111
11110111111111011100000010001111111111
11110111111111011101010100001111111111
11000000110101011100000000001111111111
10000000000000001100000000101111111111
10000000000000001101010000001111111111
11000001110101011111011110N01111111111
11110111111101011101111010001111111111
11111111111111111111111111111111111111
